0,0,0,0,0,0,0,0,0,0,0,18,18,18,18,18,18,18,0,0,0,0,0,0,0,0,0,0,0
0,0,0,0,0,0,0,0,18,18,18,18,18,18,18,18,18,18,18,18,18,0,0,0,0,0,0,0,0
0,0,0,0,0,0,18,18,18,18,18,1,1,1,1,1,1,1,18,18,18,18,18,0,0,0,0,0,0
0,0,0,0,0,18,18,18,1,1,1,1,1,1,1,1,1,1,1,1,1,18,18,18,0,0,0,0,0
0,0,0,0,18,18,1,1,1,1,1,1,1,1,1,1,1,1,1,1,1,1,1,18,18,0,0,0,0
0,0,0,18,18,1,1,1,1,1,1,1,1,1,1,1,1,1,1,1,1,1,1,1,18,18,0,0,0
0,0,18,18,1,1,1,1,1,1,1,1,1,1,1,1,1,1,1,1,1,1,1,1,1,18,18,0,0
0,0,18,18,1,1,1,1,1,1,1,1,1,1,1,1,1,1,1,1,1,1,1,1,1,1,18,0,0
0,18,18,1,1,1,1,1,1,1,1,1,1,1,1,1,1,1,1,1,1,1,1,1,1,1,18,18,0
0,18,18,1,1,1,1,1,1,1,1,1,1,18,18,18,1,1,1,1,1,1,1,1,1,1,18,18,0
0,18,18,1,1,1,1,1,1,1,1,18,18,18,18,18,18,18,1,1,1,1,1,1,1,1,18,18,0
18,18,1,1,1,1,1,1,1,1,18,18,18,21,21,21,18,18,18,1,1,1,1,1,1,1,1,18,18
18,18,1,1,1,1,1,1,1,1,18,18,21,21,21,21,21,18,18,1,1,1,0,0,0,0,0,18,18
18,18,1,0,0,0,1,1,1,18,18,21,21,21,21,21,21,21,18,18,1,1,0,0,0,0,0,18,18
18,18,1,0,30,0,1,1,1,18,18,21,21,21,21,21,21,21,18,18,1,1,0,0,31,0,0,18,18
18,18,1,0,0,0,1,1,1,18,18,21,21,21,21,21,21,21,18,18,1,1,0,0,0,0,0,18,18
18,18,1,1,1,1,1,1,1,1,18,18,21,21,21,21,21,18,18,1,1,1,0,0,0,0,0,18,18
18,18,1,1,1,1,1,1,1,1,18,18,18,21,21,21,18,18,18,1,1,1,1,1,1,1,1,18,18
0,18,18,1,1,1,1,1,1,1,1,18,18,18,18,18,18,18,1,1,1,1,1,1,1,1,18,18,0
0,18,18,1,1,1,1,1,1,1,1,1,1,18,18,18,1,1,1,1,1,1,1,1,1,1,18,18,0
0,18,18,1,1,1,1,1,1,1,1,1,1,1,1,1,1,1,1,1,1,1,1,1,1,1,18,18,0
0,0,18,18,1,1,1,1,1,1,1,1,1,1,1,1,1,1,1,1,1,1,1,1,1,18,18,0,0
0,0,18,18,1,1,1,1,1,1,1,1,1,1,1,1,1,1,1,1,1,1,1,1,1,18,18,0,0
0,0,0,18,18,1,1,1,1,1,1,1,1,1,1,1,1,1,1,1,1,1,1,1,18,18,0,0,0
0,0,0,0,18,18,1,1,1,1,1,1,1,1,1,1,1,1,1,1,1,1,1,18,18,0,0,0,0
0,0,0,0,0,18,18,18,1,1,1,1,1,1,1,1,1,1,1,1,1,18,18,18,0,0,0,0,0
0,0,0,0,0,0,18,18,18,18,18,1,1,1,1,1,1,1,18,18,18,18,18,0,0,0,0,0,0
0,0,0,0,0,0,0,0,18,18,18,18,18,18,18,18,18,18,18,18,18,0,0,0,0,0,0,0,0
0,0,0,0,0,0,0,0,0,0,0,18,18,18,18,18,18,18,0,0,0,0,0,0,0,0,0,0,0